2016 iOS教程多线程实战视频配套代码

Day01
    01. SimulatedTimeConsumingOperation                             --> 模拟耗时操作
    02. pthreadDemo                                                 --> 演示pthread线程的使用
    03. pthreadWithParam                                            --> pthread带参数的用法
    04. NSThreadDemo                                                --> 演示NSThread的使用
    05. ThreadState                                                 --> 线程状态
    06. ThreadAttribute                                             --> 线程属性
    07. ThreadSharingResources                                      --> 线程操作共享资源的问题
    08. NatomicAttribute                                            --> 原子属性
    09. AsyncDownloadPicture                                        --> 异步下载网络图片
    10. StrongAndWeak                                               --> strong和weak
    11. MessageLoop                                                 --> 演示消息循环
    12. AutoReleasePool                                             --> 自动释放池面试题
    13. AttributeModifier                                           --> 属性修饰符

Day02
    01. MessageLoop                                                 --> 消息循环
    02. ChildThreadMessageLoop                                      --> 子线程消息循环
    03. GCDDemo                                                     --> GCD演示
    04. AsyncDownloadPicture                                        --> 异步下载网络图片
    05. SerialQueue                                                 --> 串行队列
    06. ParallelQueue                                               --> 并行队列
    07. MainQueue                                                   --> 主队列
    08. SyncTask                                                    --> 同步任务
    09. Barrier                                                     --> Barrier阻塞
    10. DelayedAndOnceExecution                                     --> 延迟和一次性执行
    11. SingleCase                                                  --> 单例
    12. DispatchGroup                                               --> 调度组
    13. NSOperation                                                 --> NSOperation线程
    14. NSBlockOperation                                            --> 演示NSBlockOpeartion线程的使用
    15. InterprocessCommunication                                   --> 进程间通信

Day03
    01. MaxNumberOfConcurrent                                       --> 最大并发数
    02. LotteryMachine                                              --> 摇奖机
